form	lemma	POS
"
"	"
"	SPACE
Il	il	PRON
suit	suivre	VERB
de	de	ADP
là	là	ADV
que	que	SCONJ
les	le	DET
éléments	élément	NOUN
du	de	DET
caractère	caractère	NOUN
comique	comique	ADJ
seront	être	AUX
les	le	DET
mêmes	même	ADJ
au	au	DET
théâtre	théâtre	NOUN
et	et	CCONJ
dans	dans	ADP
la	le	DET
vie	vie	NOUN
.	.	PUNCT
Quels	quel	ADJ
sont	être	AUX
-ils	il	PRON
?	?	PUNCT
Nous	nous	PRON
n'	n'	ADV
aurons	avoir	VERB
pas	pas	ADV
de	de	DET
peine	peine	NOUN
à	à	ADP
les	le	DET
déduire	déduire	NOUN
.	.	PUNCT
