form	lemma	POS
"
"	"
"	SPACE
N'	ne	ADV
est	être	AUX
-ce	ce	PRON
pas	pas	ADV
une	un	DET
espèce	espèce	NOUN
d'	de	ADP
endurcissement	endurcissement	NOUN
professionnel	professionnel	ADJ
que	que	SCONJ
celui	celui	PRON
de	de	ADP
Tartuffe	Tartuffe	PROPN
,	,	PUNCT
s'	se	PRON
exprimant	exprimer	VERB
,	,	PUNCT
il	il	PRON
est	être	VERB
vrai	vrai	ADJ
,	,	PUNCT
par	par	ADP
la	le	DET
bouche	bouche	NOUN
d'	de	ADP
Orgon	Orgon	PROPN
:	:	PUNCT
