form	lemma	POS
"
"	"
"	SPACE
Sur	sur	ADP
le	le	DET
second	second	ADJ
point	point	NOUN
nous	nous	PRON
pourrons	pouvoir	VERB
donc	donc	ADV
nous	nous	PRON
mettre	mettre	VERB
d'	de	ADP
accord	accord	NOUN
.	.	PUNCT
J'	je	PRON
arrive	arrive	VERB
alors	alors	ADV
au	au	DET
troisième	troisième	NOUN
,	,	PUNCT
qui	qui	PRON
,	,	PUNCT
je	je	PRON
pense	pense	VERB
,	,	PUNCT
ne	ne	ADV
soulèvera	soulever	VERB
pas	pas	ADV
non	non	ADV
plus	plus	ADV
de	de	ADP
discussion	discussion	NOUN
.	.	PUNCT
