form	lemma	POS
"
"	"
"	SPACE
Mais	mais	CCONJ
ce	ce	PRON
ne	ne	ADV
sont	être	AUX
là	là	ADV
que	que	SCONJ
des	de	ADP
différences	différence	NOUN
superficielles	superficiel	ADJ
.	.	PUNCT
En	en	ADP
creusant	creuser	VERB
au	au	DET
-	-	NOUN
dessous	dessous	NOUN
d'	de	ADP
elles	lui	PRON
,	,	PUNCT
on	on	PRON
trouverait	trouver	VERB
,	,	PUNCT
croyons	croyon	NOUN
-nous	nous	PRON
,	,	PUNCT
une	un	DET
différence	différence	NOUN
plus	plus	ADP
profonde	profonde	NOUN
.	.	PUNCT
