form	lemma	POS
"
"	"
"	SPACE
Vous	vous	PRON
matérialisiez	matérialiser	VERB
ainsi	ainsi	ADV
ces	ce	DET
conditions	condition	NOUN
;	;	PUNCT
vous	vous	PRON
faisiez	faire	VERB
du	de	DET
temps	temps	NOUN
à	à	ADP
venir	venir	VERB
une	un	DET
route	route	NOUN
déjà	déjà	ADV
tracée	tracer	VERB
dans	dans	ADP
la	le	DET
plaine	plaine	NOUN
,	,	PUNCT
et	et	CCONJ
que	que	SCONJ
l'	le	DET
on	on	PRON
peut	pouvoir	VERB
contempler	contempler	VERB
du	de	DET
haut	haut	NOUN
de	de	ADP
la	le	DET
montagne	montagne	NOUN
sans	sans	ADP
